是你 (Shì Nǐ) - 梦然 (Mèng Rán)
苦咖啡·唯一 (Kǔ Kāfēi · Wéiyī) - 那奇沃夫 (Nà Qí Wò Fū), KKECHO
烂片剧情 (Làn Piàn Jùqíng) - LBI利比 (LBI Lì Bǐ)
回不去的何止时间 (Huí Bùqù De Hézhǐ Shíjiān) - 苦咖啡·唯一 (Kǔ Kāfēi · Wéiyī)
第57次取消发送 (Dì 57 Cì Qǔxiāo Fāsòng) - 菲菲公主(陆绮菲) (Fēi Fēi Gōngzhǔ (Lù Qǐ Fēi))
时差 (Shí Chā) - en (王翊恩) (en (Wáng Yì'ēn))
花是花 (Huā Shì Huā) - 渡 (Dù)
没能成为你的白马 (Méi Néng Chéngwéi Nǐ De Báimǎ) - 杨天一 (Yáng Tiān Yī)
全身而退 (Quánshēn Ér Tuì) - 徐剑秋 (Xú Jiàn Qiū)
赖我 (Lài Wǒ) - 九姨太 (Jiǔ Yí Tài)
慢慢的 - 贺一航
分手的意义 - 贺一航
爱意藏风里 - 何雨溪 & kyl3
相遇的意义 - 韩小欠
忘了所有忘不了你 - 韩小欠
人生无憾 - 韩小欠
秋叶落尽大雪飞 - 韩小欠
沦陷 - 王靖雯
总会有人 - 向思思
冬眠 - 司南
Manchild - Sabrina Carpenter
MR. - Lil Mabu & ChriseanRock
First Person Shooter - Drake
Can't Help Falling In Love - 猫王
暖灰 (2025说唱版) - 陈墨一（吖毛）/Astera-申凯
有一种遗憾叫我们 - 田园
天另一侧 - 一颗狼星
落日与鲸 - 鬼鬼Gmer
舍得 - 王唯旖
月亮照山川 - 窝窝
谦让
Jumping Machine (跳楼机) - LBI利比
嗵嗵 - DOUDOU
成人礼 - BY2
偏向
壁上观 - 邓寓君(等什么君)
转身即心痛 (说唱版) - 不良人
白鸽乌鸦相爱的戏码 - 潘成（皮卡潘）
这是你期盼的长大吗 - 张齐山ZQS
我会等 - 承桓
越来越不懂
陪我过个冬 (相思八千里) (节奏氛围版)
青花
春庭雪
只为你着迷